5,2,,,,,,
2,2,,,,,,
1,0,,,,,,
0000,0000,0000,0000,0000,0000,0000,0000
0100,0011,0110,0111,0111,0111,0011,0000
0000,1110,1101,1111,1101,1111,1011,0000
0000,1110,0011,1100,0001,1110,1011,0001
0000,1110,1101,0011,0010,1100,1011,0000
0000,1110,0001,1100,1001,0110,1011,0000
0000,1100,0101,0101,0101,1101,1001,0000
0000,0000,0000,0000,0000,0000,0000,0000