2,1,,,,,,
6,2,,,,,,
3,7,,,,,,
0000,0000,0000,0000,0000,0000,0000,0000
0000,0110,0111,0101,0111,0111,0011,0000
0000,1110,1111,0011,1110,1101,1011,0000
0000,1010,1110,1111,1011,0110,1111,0001
0000,1110,1101,1111,1111,1111,1001,0000
0000,1110,0011,1110,1111,1011,0010,0000
0000,1100,1101,1101,1101,1101,1001,0000
0000,0000,0000,0000,0000,0000,0000,0000